0000000000
0000000000
0000000000
0000000000
0000000000
0000000000
0000000000
00X0000000
0000000000
YYYYYYYYYY