0000000000
0000000000
0000000000
0X00000XX000XXX
0000000000
0000XXXX00
0000000000
00XXX00000
0000000000
YYYYYYYYYY